################################################################
#  A  #                                                        #
#     #                                                        #
#     #                                                        #
#     #        ######################################          #
#                        #                          #          #
#                        #                          #          #
###############          #                          #          #
#                        #      #############       #          #
#                        #      #           #       #          #
#       ##################      #           #       #          #
#                               #           #       #          #
#                               #           #       #          #
#                               #           #       #          #
#       #########################           #                  #
#       #                                   #                  #
#       #                                   #       #          #
#       #                                           #          #
#       #          ################                 ############
#       #                         #                            #
#       #                     B   #                            #
#       #                         #                            #
#       #          #############################################
#       #                                                      #
#       #                                                      #
#       #                                                      #
#       ##########################                             #
#       #                                                      #
#       #                                                      #
#       #                                                      #
#       ######       #################################         #
#                                                              #
#                                                              #
#                                                              #
#                                                              #
################################################################
